{
    "maze1": {
        "walls": [
            "  ", "d ", " r", "  ", "d ", "d ",
            " r", "  ", "dr", "d ", "d ", "  ",
            " r", "d ", " r", "  ", "d ", "  ",
            " r", "d ", "d ", "dr", "d ", "  ",
            "  ", "d ", " r", "  ", "dr", "  ",
            "  ", " r", "  ", " r", "  ", "  "
        ],
        "circles": [7, 18]
    },
    "maze2": {
        "walls": [
            "d ", "  ", "dr", "  ", "  ", "d ",
            "  ", "dr", "  ", "dr", "d ", "  ",
            " r", "  ", "dr", "  ", "d ", "  ",
            "  ", "dr", "  ", "dr", " r", "  ",
            " r", " r", " r", "  ", "dr", "  ",
            " r", "  ", " r", "  ", "  ", "  "
        ],
        "circles": [11, 20]
    },
    "maze3": {
        "walls": [
            "  ", "d ", " r", " r", "  ", "  ",
            "dr", " r", " r", "d ", "dr", "  ",
            "  ", " r", " r", "  ", " r", "  ",
            " r", " r", " r", " r", " r", "  ",
            " r", "d ", "dr", " r", " r", "  ",
            "  ", "  ", "  ", " r", "  ", "  "
        ],
        "circles": [22, 24]
    },
    "maze4": {
        "walls": [
            "  ", " r", "d ", "d ", "d ", "  ",
            " r", " r", "  ", "d ", "d ", "  ",
            " r", "d ", "dr", "  ", "dr", "  ",
            " r", "d ", "d ", "d ", "d ", "  ",
            "  ", "d ", "d ", "d ", " r", "  ",
            "  ", "  ", " r", "  ", " r", "  "
        ],
        "circles": [1, 19]
    },
    "maze5": {
        "walls": [
            "d ", "d ", "d ", "d ", "  ", "  ",
            "  ", "d ", "d ", "  ", "dr", "d ",
            "  ", " r", "d ", "dr", "  ", "  ",
            " r", "d ", "d ", " r", "dr", "  ",
            " r", "  ", "d ", "d ", "dr", "  ",
            " r", "  ", "  ", "  ", "  ", "  "
        ],
        "circles": [17, 34]
    },
    "maze6": {
        "walls": [
            " r", "  ", " r", "d ", "  ", "  ",
            " r", " r", " r", "  ", "dr", "  ",
            "  ", "dr", "dr", " r", "  ", "d ",
            "d ", " r", "  ", " r", " r", "  ",
            "  ", "dr", "dr", " r", "d ", "  ",
            "  ", "  ", "  ", " r", "  ", "  "
        ],
        "circles": [5, 27]
    },
    "maze7": {
        "walls": [
            "  ", "d ", "d ", " r", "  ", "  ",
            " r", "  ", "dr", "d ", "dr", "  ",
            "d ", "dr", "  ", "dr", "  ", "d ",
            "  ", " r", "  ", "d ", "dr", "  ",
            " r", "dr", "d ", "d ", " r", "  ",
            "  ", "  ", "  ", "  ", "  ", "  "
        ],
        "circles": [2, 32]
    },
    "maze8": {
        "walls": [
            " r", "  ", "d ", " r", "  ", "  ",
            "  ", "d ", "dr", "d ", "dr", "  ",
            " r", "  ", "d ", "d ", " r", "  ",
            " r", "d ", " r", "d ", "d ", "d ",
            " r", " r", "d ", "d ", "d ", "d ",
            "  ", "  ", "  ", "  ", "  ", "  "
        ],
        "circles": [4, 21]
    },
    "maze9": {
        "walls": [
            " r", "  ", "d ", "d ", "  ", "  ",
            " r", " r", "  ", "dr", " r", "  ",
            "  ", "d ", "dr", "  ", "dr", "  ",
            " r", " r", "  ", "dr", "d ", "  ",
            " r", " r", " r", "  ", " r", "d ",
            "  ", " r", "  ", " r", "  ", "  "
        ],
        "circles": [9, 25]
    }
}